#######################
#..........#..........#
#.###.####.#.####.###.#
#.....................#
#.###.#.#######.#.###.#
#.....#....#....#.....#
#####.#### # ####.#####
    #.#         #.#
    #.#         #.#
#####.  #GG   #  .#####
     .  #     #  .
#####.# ####### #.#####
    #.#         #.#
    #.#         #.#
#####.# ####### #.#####
#..........#..........#
#.###.####.#.####.###.#
#...#......P......#...#
###.#.#.#######.#.#.###
#.....#....#....#.....#
#.########.#.########.#
#.....................#
#######################