########################
#..........##..........#
#.##.#####.##.#####.##.#
#.......................#
#.##.#.#######.#.##.#
#....#....##....#....#
####.####.##.####.####
   #.#..........#.#   
####.#.##  ##.#.####
#......##  ##......#
####.#.########.#.####
   #.#....P.....#.#   
####.####.##.####.####
#....#....##....#....#
#.##.#.#######.#.##.#
#..G........G.......G.#
#.##.#####.##.#####.##.#
#..........##..........#
########################