##################
#........#.......#
#.####.###.####.#
#................#
###.##.####.##.###
#...##......##...#
#.####.####.####.#
#................#
#.##.########.##.#
#....#..P...#....#
#.##.#.GGGG.#.##.#
#....#......#....#
#.##.########.##.#
#................#
#.####.####.####.#
#...##......##...#
###.##.####.##.###
#................#
#.####.###.####.#
#........#.......#
##################